15
20
XXXXXXXXXXXXXXXXXXXX
X H ###XE   ###    X
X #   #X#######    X
X # P X#    E      X
X ### X## ###      X
X  L XX###  X#     X
X  # X #####X#     X
X E XXX    S       X
X ### X E   ##     X
X T ## X     E     X
X ######X   E      X
X    # X##         X
X  E  X ###        X
X                  X
XXXXXXXXXXXXXXXXXXXX