15
20
XXXXXXXXXXXXXXXXXXXX
X H      X     P   X
X   #    X   ###   X
X     #  X    E    X
X  ###   X#        X
X    L    X #      X
X   #   XXXX       X
X        E   S     X
X   ##      X      X
X    T     X       X
X   ###### X       X
X           X      X
X                  X
X                  X
XXXXXXXXXXXXXXXXXXXX