15
20
XXXXXXXXXXXXXXXXXXXX
X H   ##  X   E    X
X  #   X ## ####   X
X  # P X    #      X
X ###  X###        X
X   L  X   #   E   X
X  ## XXX####      X
X     XX     S     X
X  ##  X      #    X
X   T  X    E      X
X ######X          X
X    #   X         X
X        X         X
X                  X
XXXXXXXXXXXXXXXXXXXX